1111111111111111
1E00011111111111
1100111111111111
1110011111111111
1P00C00111111111
1111111111111111