1111111111
1E010C1011
1CCCC00011
1P00110111
1111111111